NO ./includes/sprites/north.xpm
SO ./includes/sprites/south.xpm
WE ./includes/sprites/west.xpm
EA ./includes/sprites/east.xpm



F 124,252,0
C 135,206,235

        1111111111111111111111111
        1000000000110000000000001
        1011000001110000000000001
        1001000000000000000000001
111111111011000001110000000000001
100000000011000001110111111111111
111101111111110111000000D0001
111101111111110111010100D0001
110000001101010111000000D0001
100000000000000011000000D0001
100000000000000011010100D0001
11000001110101011111011110N0111
11110111  1110101  101  1010001
11111111  1111111   1    1 111